//////////////////////////////Map_Layouts//////////////////////////////////////
//    X 0 0 0 0 0 T | 0 0 0 0 0 0 0 0 0 0 0 0 0 0 0 0
//    0 0 0 0 0 0 T | 0 0 P 0 0 0 0 0 0 0 0 W 0 0 0 0
//    0 0 0 0 0 0 T | 0 0 0 0 0 0 0 0 0 0 0 0 0 0 0 0
//    0 0 0 0 0 0 T | 0 0 0 0 0 0 0 0 0 0 0 0 0 0 0 0
//    _______   ____| 0 0 0 0 0 0 0 0 0 0 0 0 0 0 0 0
//    0 0 0 0 0 0 0 0 0 0 0 0 0 0 0 0 0 0 0 0 0 0 0 0
//    0 0 0 0 0 0 0 0 0 0 0 0 0 0 0 0 0 0 0 0 0 0 0 0
//    0 0 0 0 0 0 0 0 0 0 0 0 0 0 0 0 0 0 0 0 0 0 0 0
//    0 0 W 0 0 0 0 0 0 0 0 0 0 0 0 0 0 0 0 _________
//    0 0 0 0 0 0 0 0 0 0 0 0 0 0 0 0 0 0 0 | P 0 0 0
//    0 0 0 0 0 0 0 0 0 0 0 0 0 0 0 0 0 0 0 | 0 0 0 0
//    
//
//
//
//
//
//
//
